50_50_400_50
400_50_400_400
400_400_50_400
50_400_50_100
50_100_350_100
350_100_350_350
350_350_100_350
100_350_100_150
100_150_300_150
300_150_300_300
300_300_150_300
150_300_150_200
150_200_250_200
250_200_250_250
250_250_200_250
200_250_225_225
